*
%FSLAX25Y25*%
%MOIN*%
%ADD10C,0.092520*%
%IPPOS*%
%LN2rl*%
%LPD*%
G54D10*
X57084Y57087D03*
M02*
