*
%FSLAX25Y25*%
%MOIN*%
%ADD10C,0.092520*%
%IPPOS*%
%LNdrl*%
%LPD*%
G54D10*
X57103Y57088D03*
M02*
