*
%FSLAX25Y25*%
%MOIN*%
%ADD10C,0.124016*%
%IPPOS*%
%LNdrl*%
%LPD*%
G54D10*
X57087Y57115D03*
M02*
