*
%FSLAX25Y25*%
%MOIN*%
%ADD10C,0.124016*%
%IPPOS*%
%LN2rl*%
%LPD*%
G54D10*
X57086Y57087D03*
M02*
